Generated files for level 'moba_level':


--- TERRAIN PREVIEW ---
   0123456789012345678901234567890123456789
 0 GGGGGGGGGGGGGGGGGGGRGGGGGGGGGGGGGGGGGGGG
 1 GGGGGGGGGGGGGGGGGGGGRGGGGGGGGGGGGGGGGGGG
 2 GGPPPPPPPPPPPPPPPPPPBPPPPPPPPPPPPPPPPGGG
 3 GGGGH44GGGGGGGGGGGGGGRGGGGGGGGGGGG044GGG
 4 GGG00404GGGGGGGGGGGGGRRGGGGGGGGG4H044GGG
 5 GGGH44000GGGGGGGGGGGGGGRGGGGGGGGH44H04GG
 6 GGGHH0H4HHGGGGGGGGGGGGGRGGGGGG0H440H4GGG
 7 GGGGH40040HGGGGGGGGGGGGRGGGGGGH0HH444GGG
 8 GGGG4H44HH44GGGGGGGGGGGRGGGG4H040H00GGGG
 9 GGGGGG0H0044HGGGGGGGGGGGRGGG44H0444GGGGG
10 GGGGGG4H40HH44GGGGGGGGGGRG04H440HHGGGGGG
11 GGGGGGGG4HHHH4HGGGGGGGGGGR404HH4HGGGGGGG
12 GGGGGGGG40H4H04HGGGGGGGG04044H44GGGGGGGG
13 GGGGGGGGGG004H400GGGGGGG404HH40GGGGGGGGG
14 GGGGGGGGGG0H40HH4GGGGGG4HH0444GGGGGGGGGG
15 GGGGGGGGGGGG0HH004GGGGGH0HH40GGGGGGGGGGG
16 GGGGGGGGGGGG4H404GGGGGG04040RGGGGGGGGGGG
17 GGGGGGGGGGGGGGH40GGGGGGG000GGRGGGGGGGGGG
18 GGPPGGGGGGGGGGGGGGGGGGGGGGGGGRGGGGGGGGGG
19 GGPPPPPPPPPPPPPPPPPPPPPPPPPPBBPPPPPPPGGG
20 GGPPGGGGGGGGGGGGGGGGGGGGGGGGRGGGGGGGGGGG
21 GGGGGGGGGGGGGGGGGGGGGGGGGGGGRGGGGGGGGGGG
22 GGGGGGGGGGGGGGGGGGGGGGGGGGGRGGGGGGGGGGGG
23 GGGGGGGGGGGGGG4HHGGGGGGG4H0RGGGGGGGGGGGG
24 GGGGGGGGGGGG4H40HGGGGGGHH044GGGGGGGGGGGG
25 GGGGGGGGGGGG04HH44GGGGG044440GGGGGGGGGGG
26 GGGGGGGGGGH0H4040GGGGGG44H0444GGGGGGGGGG
27 GGGGGGGGGG0H440H4GGGGGGG4H0H404GGGGGGGGG
28 GGGGGGGG44HH0H4HGGGGGGGGHH440HH0GGGGGGGG
29 GGGGGGGGH0H4HH0GGGGGGGGGRGH040444GGGGGGG
30 GGGGGG44444004GGGGGGGGGRGG4HH44HH4GGGGGG
31 GGGGGG44HHH4HGGGGGGGGGGRGGGG444H04HGGGGG
32 GGGG0H4HHHH4GGGGGGGGGGRGGGGG00H444HHGGGG
33 GGGG04404H0GGGGGGGGGGGRGGGGGGG004HH04GGG
34 GGG0H04000GGGGGGGGGGGRGGGGGGGGH0HH000GGG
35 GGGHH4H44GGGGGGGGGGGGRGGGGGGGGGG040H0HGG
36 GGG40H4HGGGGGGGGGGGGRGGGGGGGGGGG404H4GGG
37 GGPP400PPPPPPPPPPPPPBPPPPPPPPPPPPP0H0GGG
38 GGGGGGGGGGGGGGGGGGGRGGGGGGGGGGGGGGGGGGGG
39 GGGGGGGGGGGGGGGGGGGRGGGGGGGGGGGGGGGGGGGG
Legend: P=Start, L=POI, !=Unreachable POI, .=Empty, R=Ruin, W=Water
